12 10 11 11 11 10 12 11 13 10 15 10 14 13 11 13 10 11 15 11 12 11 18 17 19 11 10 13 11 10 10 12 10 13 11 12 12 10 12 11 13 15 10 14 13 14 10 13 12 11
10 15 10 14 11 12 12 13 13 11 13 14 14 15 13 12 13 15 12 11 13 15 18 17 19 10 15 11 11 11 11 11 13 13 10 12 11 11 13 10 13 12 12 15 13 13 14 13 10 12
13 10 10 14 12 12 12 10 10 10 12 10 14 14 11 10 13 15 10 13 10 12 18 17 19 11 13 14 15 10 12 10 14 11 12 14 10 10 12 11 10 11 15 12 10 15 11 10 13 11
10 11 13 11 13 10 15 14 12 11 12 11 10 13 10 10 11 12 13 13 13 13 18 17 19 13 12 11 12 11 11 14 11 10 10 13 14 11 14 10 13 12 15 12 12 12 14 14 10 12
10 10 13 10 12 10 12 11 11 11 10 13 10 15 12 12 11 12 13 11 10 13 18 17 19 10 12 14 13 13 11 12 13 10 12 11 10 13 13 12 14 10 10 10 15 15 11 12 10 12
15 13 12 12 13 12 10 12 12 11 10 13 14 13 10 10 13 15 10 12 15 15 18 17 19 12 11 13 10 14 12 10 13 14 10 13 11 11 11 10 12 11 13 11 12 13 13 11 10 12
12 12 11 13 13 11 10 10 12 13 12 10 15 13 13 12 15 12 13 13 10 13 18 17 19 11 15 13 10 10 14 14 11 13 12 12 12 11 13 13 11 15 12 13 13 10 10 12 12 13
11 14 11 13 14 13 11 11 12 10 10 12 13 11 12 10 10 10 10 11 15 15 18 17 19 11 15 11 12 12 10 13 13 10 13 11 10 11 13 12 13 12 13 13 12 10 11 10 12 14
10 11 11 11 13 13 11 12 10 12 10 13 13 11 11 13 13 12 12 10 11 11 18 17 19 11 13 10 13 13 11 10 12 13 13 11 12 14 14 15 11 14 13 15 13 12 13 12 14 10
10 13 15 13 12 11 13 10 10 13 12 10 12 13 10 10 13 15 13 12 15 11 18 17 19 13 12 13 11 10 10 15 13 16 12 12 13 10 13 12 15 13 10 13 16 12 13 10 12 13
11 12 13 16 12 13 10 12 12 13 14 10 15 10 13 12 15 13 12 13 12 15 18 17 19 12 13 12 11 14 14 15 12 11 13 12 14 10 13 13 10 12 10 10 11 12 10 11 13 11
12 14 10 13 11 15 11 13 11 12 13 12 13 15 10 10 11 12 10 10 12 11 18 17 19 12 11 13 11 11 11 14 11 10 10 13 12 11 10 10 11 13 12 13 13 12 11 11 15 11
15 13 11 13 12 11 10 15 10 12 12 10 11 14 12 10 11 12 15 12 14 12 18 17 19 12 15 12 15 12 14 10 10 12 11 11 13 10 15 10 11 14 13 11 12 11 10 10 12 15
11 12 12 10 15 14 13 11 14 13 13 11 13 11 11 10 12 14 12 15 11 10 18 17 19 11 15 10 10 10 13 12 12 12 15 10 11 12 11 15 13 12 11 11 10 10 12 11 15 12
10 13 15 11 10 13 11 11 10 10 16 14 13 14 12 13 11 11 11 12 12 12 18 17 19 13 13 10 12 12 11 11 10 11 10 11 10 10 11 11 13 13 14 11 13 11 10 10 12 12
13 11 15 13 11 10 12 11 13 10 13 12 13 11 11 10 16 13 11 15 10 12 18 17 19 12 10 14 12 16 12 13 11 10 15 13 10 11 12 10 15 10 10 13 12 12 15 15 11 10
12 12 11 11 15 10 11 10 12 12 13 10 11 15 15 11 13 15 10 11 10 12 18 17 19 13 13 13 12 12 13 14 12 15 11 10 10 12 10 13 10 10 10 11 12 10 11 11 14 13
12 10 12 12 15 13 15 11 11 11 13 14 12 11 13 11 13 12 14 12 10 15 18 17 19 10 11 10 14 13 15 12 15 11 12 13 12 13 13 15 10 12 10 10 12 11 13 12 12 15
13 12 11 15 11 11 10 10 12 12 13 12 10 12 11 13 11 11 13 11 13 10 18 17 19 10 11 15 11 15 12 10 10 13 13 10 10 11 14 15 13 13 10 12 12 10 14 12 11 13
10 12 11 13 14 11 10 12 13 11 12 15 10 12 12 10 13 15 10 14 12 12 18 17 19 11 13 13 15 11 13 10 13 10 11 10 12 15 12 11 13 11 10 12 10 13 12 11 12 11
10 11 10 16 10 13 11 10 10 11 11 11 10 10 10 14 13 15 11 10 12 13 18 17 19 14 10 11 13 10 13 13 10 11 12 14 13 11 11 14 10 12 11 11 12 11 10 11 10 13 
14 11 13 15 10 15 12 10 14 13 11 13 13 12 11 15 13 11 10 13 13 11 18 17 19 10 15 13 11 12 12 10 11 10 11 11 11 13 13 11 12 10 12 10 13 13 11 11 13 13 
12 12 10 11 11 12 13 11 11 13 10 13 13 11 10 12 13 13 11 12 14 14 18 17 19 13 15 13 12 13 12 14 10 12 15 10 11 12 11 15 13 12 11 11 10 10 12 11 15 12
11 12 14 13 10 11 14 14 11 13 11 11 16 13 11 12 16 10 11 12 14 12 18 17 19 14 13 11 13 13 12 11 15 13 11 10 13 13 11 10 15 12 10 15 13 11 12 12 10 11
10 14 13 12 10 14 13 11 13 10 11 10 12 10 13 12 15 12 10 12 12 11 18 17 19 15 11 12 12 13 14 13 11 15 14 12 11 12 10 14 15 13 13 11 14 11 12 13 13 12
10 14 11 11 15 13 12 13 10 13 12 13 10 11 12 10 16 13 13 10 13 11 18 17 19 16 14 12 12 12 10 15 10 11 14 10 11 11 12 13 13 15 10 14 13 10 10 16 11 15
13 14 11 12 10 10 11 12 11 11 15 10 12 15 10 13 12 15 10 13 13 15 18 17 19 15 12 10 10 12 12 13 10 10 11 11 13 13 15 10 13 15 10 10 10 12 14 12 10 13
13 12 11 12 10 11 11 11 13 12 10 10 14 10 11 13 10 11 13 12 13 10 18 17 19 11 12 12 13 10 13 14 10 15 11 13 10 10 12 14 15 14 13 11 12 12 15 10 11 13
11 14 10 10 10 10 12 15 12 13 14 12 10 12 13 10 16 14 10 13 13 10 18 17 19 12 10 11 11 12 11 13 11 12 11 12 11 12 13 11 11 10 13 10 13 11 11 13 13 11
11 13 10 10 12 10 12 12 11 11 12 13 14 11 12 11 12 12 10 11 14 12 18 17 19 12 12 11 11 13 13 11 13 16 12 11 13 12 12 15 11 15 10 10 12 13 13 13 10 13
12 14 11 13 13 12 12 15 16 11 15 12 12 10 12 12 10 12 11 10 13 14 18 17 19 13 15 13 10 12 12 13 15 12 13 10 10 16 13 13 12 15 12 12 10 16 13 10 11 13
12 12 11 12 13 11 13 10 11 14 15 15 13 15 16 12 13 11 10 13 13 12 18 17 19 11 15 15 10 13 10 11 11 13 10 15 12 13 12 11 12 10 15 11 13 12 12 10 14 12
12 12 10 14 13 10 16 15 13 14 15 13 13 12 12 10 11 11 13 12 10 13 18 17 19 15 10 10 10 13 13 10 13 13 13 13 11 10 15 12 12 14 12 11 10 12 13 10 15 14
11 15 15 13 12 11 12 10 12 12 11 14 11 13 12 13 14 11 13 11 11 15 18 17 19 13 10 15 15 15 10 10 10 11 12 14 12 13 13 11 13 15 13 15 12 13 10 15 10 13
13 15 13 10 11 10 14 12 12 13 12 13 13 11 10 11 12 12 10 12 16 10 18 17 19 12 11 11 11 13 12 10 13 10 10 13 10 10 13 13 11 10 12 14 13 11 13 15 11 10
12 13 11 14 10 12 13 12 11 10 10 13 11 12 11 10 12 12 12 15 13 13 18 17 19 12 11 10 11 11 10 13 10 10 12 11 14 12 12 13 14 12 13 13 13 15 11 11 13 12
12 12 13 13 11 10 13 13 13 12 10 16 10 13 13 13 11 14 10 10 11 10 18 17 19 10 10 14 10 13 12 12 12 10 13 12 13 10 11 11 13 13 12 14 10 13 10 12 14 13
10 11 11 11 10 10 10 14 13 15 11 10 12 13 10 11 13 14 10 11 13 10 18 17 19 11 12 14 13 11 11 14 10 12 11 11 12 11 10 11 10 13 14 11 13 15 10 15 12 10
13 13 12 11 13 12 10 14 11 13 11 10 13 11 14 15 10 12 11 13 13 13 18 17 19 10 10 15 11 12 13 13 12 12 13 10 14 13 10 13 14 15 13 10 12 11 14 10 13 10
12 11 10 10 14 10 13 10 10 12 12 13 11 13 10 15 13 10 11 10 13 12 18 17 19 14 15 10 11 15 13 11 13 10 11 11 12 10 10 10 12 14 11 12 15 10 12 13 10 10
12 10 15 15 11 10 15 13 12 10 12 14 11 11 10 13 12 12 11 15 12 14 18 17 19 14 12 13 13 13 10 11 11 13 12 10 13 12 11 11 13 12 13 13 10 15 12 15 16 10
11 11 11 13 12 16 12 13 11 12 10 13 14 11 13 11 10 10 14 10 11 14 18 17 19 10 12 12 11 11 10 16 10 13 11 13 13 12 13 10 10 12 13 11 11 11 11 10 13 11
13 11 11 11 11 13 12 12 12 13 16 11 12 12 11 12 12 11 15 10 12 10 18 17 19 14 13 12 13 12 15 12 15 11 11 13 10 11 12 12 10 13 10 12 12 13 12 12 11 11
12 10 10 13 13 13 12 13 13 11 10 11 12 14 11 10 10 10 13 11 13 12 18 17 19 11 14 12 14 13 12 10 10 10 10 13 13 13 11 11 10 10 15 12 15 12 11 12 13 15
11 11 10 10 12 11 12 11 11 11 11 14 13 12 12 13 11 13 13 12 10 11 18 17 19 11 14 12 15 10 12 10 11 13 13 13 15 14 11 14 11 13 14 13 10 15 10 12 11 11
15 11 13 13 12 16 12 12 11 15 12 12 10 12 12 12 11 13 10 11 13 11 18 17 19 12 11 13 15 13 13 11 12 12 10 13 10 12 10 13 13 15 14 12 11 13 14 15 11 14
12 11 10 13 10 10 13 13 12 13 11 12 13 12 14 11 13 11 10 11 10 14 18 17 19 10 15 13 12 13 10 13 12 15 14 14 12 10 15 13 13 10 10 13 15 11 11 10 15 12
10 10 14 11 11 12 12 12 11 11 12 11 11 10 12 13 13 12 12 12 12 14 18 17 19 11 11 13 12 10 14 13 12 10 13 12 10 10 15 15 12 12 11 12 10 11 12 11 10 11
14 10 13 11 10 10 13 10 11 13 10 13 13 10 13 11 12 11 15 13 12 10 18 17 19 11 15 14 11 13 10 11 11 11 12 13 13 13 15 13 13 14 12 12 12 11 15 12 11 15
12 13 11 13 10 10 11 13 11 13 13 10 10 15 13 11 13 13 12 11 13 14 18 17 19 13 12 14 12 11 11 11 15 12 10 15 15 13 11 10 11 12 10 13 13 12 10 10 10 13
